NO xpm/north.xpm
SO xpm/south.xpm
WE xpm/west.xpm
EA xpm/east.xpm
F 2,150,100
C 50,10,180

11111111111111111111111111111111111111111111111111
10000000000000000000000000000000000000000000000001
10000000000000000000000000000000000000000000000001
10000000000000000011111111000000000000000000000101
10000000000000000010010001000000000000000000000101
10000000000000001011000101000000000000000000000101
10000000000000001011111101000000000000000000000101
10000000000000111000000001000000000000000000000101
100000000000001 1111111111000000000000000000000101
10000000000000010000000000000000000000000000000001
10000000000000001000000000000000000000000000000101
10000000000000000100000000000000000000000000000101
10000000000000000010000000000000000000000000000101
10000000000000000001000000000000000000000000000101
100000000000000000000000000000000000000000000001S1
11111111111111111111111111111111111111111111111111
